"135","SCREW M5 X 10 PAN HD PHILIPS","060607C42",200,400,200,200,0.0605,1,0.0605,1169,0,1169,70.7245,"2023-09-04 11:29:52","Kanban Stock",2,1
"136","SCREW M5 X 12 PAN HD PHILIPS","060607C43",200,400,200,200,0.035,1,0.035,1029,600,1629,57.015,"2023-09-04 11:30:13","Kanban Stock",2,0
"140","SCREW M5 X 25 PAN HD PHILLIPS","060607C46",100,300,100,200,0.067,1,0.067,420,1000,1420,95.14,"2023-09-04 11:38:24","Kanban Stock",2,0
"93","SCREW M5 X 30 PAN HEAD","060607P47",200,600,200,400,0.0434,1,0.0434,523,1000,1523,66.0982,"2023-09-04 11:09:31","Kanban Stock",2,0
"155","SCREW M8 X 40 HEX SET 8.8 H/T","060609C30",100,300,100,200,0.1271,1,0.1271,200,0,200,25.42,"2023-10-04 09:51:23","Kanban Stock",2,0
"120","SCREW M10 X 30 HEX SET 8.8 H/T","060609C50",100,300,100,200,0.1295,1,0.1295,53,700,753,97.5135,"2023-09-04 11:23:15","Kanban Stock",2,0
"124","SCREW M12 X 40 HEX SET 8.8 F/T","060609C82",50,150,50,100,19.09,100,0.1909,86,150,236,45.0524,"2023-09-04 11:25:09","Kanban Stock",2,0
"146","M6X16 PAN HD PHILIPS","060618C01",400,1200,400,800,0.0605,1,0.0605,400,800,1200,72.6,"2023-09-06 11:40:56","Kanban Stock",2,0
"147","6 x 20mm SCREW","15888",400,1200,400,800,5.68,100,0.0568,201,1000,1201,68.2168,"2023-09-04 11:41:16","Kanban Stock",2,0
"130","RIVET BLIND ALUM DOME (ASP-5-2)","18289",1000,2000,1000,1000,0.0182,1,0.0182,0,2000,2000,36.4,"2023-10-06 09:37:37","Kanban Stock",2,0
"89","4 x 20mm screw","28378",600,1200,600,600,4.24,100,0.0424,404,600,1004,42.5696,"2023-09-04 11:08:05","Kanban Stock",2,0
"137","SCREW STEEL PAN-HD POZI 5X20MM","28388",400,800,400,400,0.0709,1,0.0709,400,400,800,56.72,"2023-09-04 11:30:54","Kanban Stock",2,0
"109","M8 x 16 Hex Screw","30153",100,200,100,100,8.86,100,0.0886,305,967,1272,112.699,"2023-09-04 11:17:33","Kanban Stock",2,0
"111","SCREW SET H/T GR8.8 HEX 8x20mm","30154",400,1200,400,800,0.07,1,0.07,400,3000,3400,238,"2023-09-20 09:18:08","Kanban Stock",2,0
"108","SCR-HEX-ISO4017-8.8-WS13-(A2K) - M8x12","30157",100,200,100,100,0.0727,1,0.0727,100,200,300,21.81,"2023-09-04 11:16:59","Kanban Stock",2,0
"156","SCREW SET HIGHTENSILE GR8.8 8x50MM","30208",100,300,100,200,12.64,100,0.1264,94,300,394,49.8016,"2023-09-04 11:44:50","Kanban Stock",2,0
"92","4mm nut","3167",1000,1000,0,1000,0.69,100,0.0069,4646,0,4646,32.0574,"2023-09-04 11:08:51","Kanban Stock",2,1
"116","8mm Nut","3179",500,2000,500,1500,0.0273,1,0.0273,0,0,0,0,"2023-10-04 09:48:15","Kanban Stock",2,0
"122","NUT HEX-STEEL TRIVALENT-ZINC 10MM","3180",400,1200,400,800,0.05,1,0.05,400,600,1000,50,"2023-09-04 11:23:57","Kanban Stock",2,0
"167","M12 HEX NUT CL 8 ZP","3181",200,600,200,400,0.09,1,0.09,200,500,700,63,"2023-10-04 09:54:41","Kanban Stock",2,0
"90","4mm Spring Washer","33031",1000,1000,0,1000,0.007,1,0.007,6728,0,6728,47.096,"2023-09-04 11:07:45","Kanban Stock",2,1
"158","M8 x 3 x 2.0 SPRING WASHER ZP","33042",1500,4500,1500,3000,0.015,1,0.015,1500,1500,3000,45,"2023-09-06 12:31:59","Kanban Stock",2,0
"164","WASHER SPRING COIL ZINC (STD) MM 10X3.5X2.2","33045",400,1200,400,800,1.9,100,0.019,779,400,1179,22.401,"2023-09-04 11:49:22","Kanban Stock",2,0
"179","8MM FL WASHER SS","363400108",250,250,0,250,0.0224,1,0.0224,261,0,261,5.8464,"2023-09-04 11:54:40","Kanban Stock",2,1
"50","SCREW THRD/CUTT TYPE 23 PAN-PH STAIN 4 X 1/4","3665202316",1000,2000,1000,1000,28.84,1000,0.02884,1000,1000,2000,57.68,"2023-09-06 12:27:31","Kanban Stock",2,0
"51","Drilling scrw hexagon hd flanged inch SCR-SDM-HWF-WS5/16-(CL2)-12G_14X20","3665202420",500,1000,500,500,0.0909,1,0.0909,392,1500,1892,171.983,"2023-09-04 10:42:12","Kanban Stock",2,0
"88","SCREW STEEL PAN-HD POZI 4X16MM","41311",400,1200,400,800,0.02,1,0.02,1310,200,1510,30.2,"2023-09-04 11:07:14","Kanban Stock",2,0
"121","SCREW M10 x 35 SET H/T GR8.8 HEX-HD","415",100,300,100,200,0.1808,1,0.1808,100,200,300,54.24,"2023-10-04 10:04:44","Kanban Stock",2,0
"145","M6 X 12 HEX SET SCREW CL 8.8 ZINC SILVER","41522",100,100,0,100,0.0409,1,0.0409,194,0,194,7.9346,"2023-09-04 11:40:14","Kanban Stock",2,1
"123","SCREW SET H/T GR8.8 HEX TRIV.ZINC MM 12X35","432",50,150,50,100,17.65,100,0.1765,50,300,350,61.775,"2023-09-04 11:24:42","Kanban Stock",2,0
"94","5mm SPRING WASHER ZP","5891",1000,1000,0,1000,0.008,1,0.008,3578,0,3578,28.624,"2023-09-04 11:10:01","Kanban Stock",2,1
"127","WASHER SPRING COIL TRIV-480 MM 12X4X2.5","801",400,1200,400,800,3,100,0.03,501,0,501,15.03,"2023-09-04 11:26:14","Kanban Stock",2,1
"114","M8 X 35 HEX SET SCREW CL 8.8 Z","81835",200,600,200,400,0.1247,1,0.1247,200,900,1100,137.17,"2023-09-08 08:39:07","Kanban Stock",2,0
"91","4mm Flat Washer (small)","8344",1000,1000,0,1000,6,1000,0.006,5831,0,5831,34.986,"2023-09-04 11:08:33","Kanban Stock",2,1
"95","5mm FLAT WASHER 5 x 10 x 1mm","8345",1000,1000,0,1000,0.0074,1,0.0074,4952,0,4952,36.6448,"2023-09-04 11:10:29","Kanban Stock",2,1
"159","WSH-FL-AS1237-BRIGHT-NORMAL- (A2K)-D8 4R","8347",1500,4500,1500,3000,0.015,1,0.015,1500,3000,4500,67.5,"2023-09-27 09:10:07","Kanban Stock",2,0
"165","10mm Flat washer","8348",400,1200,400,800,2.32,100,0.0232,400,400,800,18.56,"2023-09-20 09:21:28","Kanban Stock",2,0
"126","WASHER FLAT STEEL BRIGHT (STD) ZINC MM 12X24X1.6","8349",400,1200,400,800,3,100,0.03,673,500,1173,35.19,"2023-09-04 11:25:52","Kanban Stock",2,0
"103","6mm Spring coil Zinc Washer 1/4x1/16/1/16","8691",1000,2000,1000,1000,19.56,1000,0.01956,1000,1000,2000,39.12,"2023-09-04 11:14:40","Kanban Stock",2,0
"01","Ferrule Insulated Black 1.50mm","BL015",1500,4500,1500,3000,8.11,500,0.01622,1500,3000,4500,72.99,"2023-09-04 09:51:27","Kanban Stock",2,0
"03","Ferrule Insulated Grey 2.50mm","BL025",500,1500,500,1000,7.95,500,0.0159,500,2500,3000,47.7,"2023-09-08 08:43:27","Kanban Stock",2,0
"04","Ferrule Insulated Grey 2.50mm Long","BL025L",500,1500,500,1000,10.52,500,0.02104,500,1000,1500,31.56,"2023-08-02 09:18:34","Kanban Stock",2,0
"06","Ferrule Insulated Orange 4mm","BL040",500,1500,500,1000,2.82,100,0.0282,1773,3400,5173,145.879,"2023-06-28 14:33:06","Kanban Stock",2,0
"07","Ferrule 4mm x 18mm Orange","BL040XL",1000,3000,1000,2000,5.3,100,0.053,1000,0,1000,53,"2023-10-06 09:51:44","Kanban Stock",2,0
"09","Ferrule Insulated Green 6mm","BL060",300,900,300,600,6.02,100,0.0602,300,400,700,42.14,"2023-10-06 09:47:46","Kanban Stock",2,0
"10","Ferrule Insulated Green 6mm Long","BL060XL",300,900,300,600,4.98,100,0.0498,849,400,1249,62.2002,"2023-08-28 12:42:11","Kanban Stock",2,0
"12","Ferrule Insulated Brown 10mm","BL100",200,600,200,400,5.02,100,0.0502,677,1800,2477,124.345,"2023-06-28 14:33:06","Kanban Stock",2,0
"13","Ferrule Brown 10mm2 x 18mm","BL100L",200,600,200,400,6.99,100,0.0699,475,2500,2975,207.952,"2023-06-28 14:33:06","Kanban Stock",2,0
"14","16mm Ferrule Insulated White","BL160",200,600,200,400,6.99,100,0.0699,200,1800,2000,139.8,"2023-09-08 08:48:36","Kanban Stock",2,0
"15","Ferrule Insulated White 16mm Long","BL160L",200,600,200,400,7.33,100,0.0733,200,300,500,36.65,"2023-09-08 08:48:21","Kanban Stock",2,0
"16","25mm Ferrule Insulated Black","BL250",150,450,150,300,5.65,50,0.113,68,900,968,109.384,"2023-09-04 10:24:36","Kanban Stock",2,0
"17","Ferrule Insulated Black 25mm Long","BL250L",100,300,100,200,7.65,50,0.153,198,750,948,145.044,"2023-09-04 10:25:04","Kanban Stock",2,0
"18","Ferrule Insulated Red 35mm","BL350",60,180,60,120,2.99,20,0.1495,141,660,801,119.749,"2023-09-04 10:25:44","Kanban Stock",2,0
"19","Ferrule Insulated Red 35mm Long","BL350L",60,180,60,120,3,20,0.15,109,720,829,124.35,"2023-09-04 10:26:08","Kanban Stock",2,0
"20","Ferrule Insulated Blue 50mm","BL500",50,150,50,100,3.51,10,0.351,41,300,341,119.691,"2023-09-04 10:26:42","Kanban Stock",2,0
"21","Ferrule Insulated Yellow 70mm","BL700",40,120,40,80,7.15,10,0.715,37,290,327,233.805,"2023-09-04 10:27:06","Kanban Stock",2,0
"22","Ferrule Insulated Red 95mm","BL950",20,20,0,20,8.9,10,0.89,41,0,41,36.49,"2023-09-04 10:27:34","Kanban Stock",2,1
"02","Ferrule Twin Black 2 x 1.5mm","BLT015",500,1500,500,1000,3.7,100,0.037,500,1500,2000,74,"2023-08-02 09:15:30","Kanban Stock",2,0
"05","Ferrule Twin Grey 2 x 2.5mm","BLT025",500,1500,500,1000,5.7,100,0.057,500,1000,1500,85.5,"2023-09-27 09:32:08","Kanban Stock",2,0
"08","Ferrule Twin Orange 2 x 4mm","BLT040",200,600,200,400,7.33,100,0.0733,826,1000,1826,133.846,"2023-06-28 14:33:06","Kanban Stock",2,0
"11","Ferrule Twin Yellow 2 x 6mm","BLT060",100,300,100,200,8.66,100,0.0866,516,500,1016,87.9856,"2023-09-25 21:16:08","Kanban Stock",2,0
"183","M6x16 BOLT","CCCCCC",200,200,0,200,0,0,\N,494,0,494,\N,"2023-09-04 11:55:57","Kanban Stock",2,1
"68","50 X 8mm LUG","COPY-BIN67",0,0,0,0,1.04,1,1.04,1,0,1,1.04,"2023-09-04 10:56:13","Kanban Stock",2,1
"73","70mm Copper Lug 8mm Stud Bell","COPY-BIN72",0,0,0,0,1.33,1,1.33,1,0,1,1.33,"2023-09-04 10:57:54","Kanban Stock",2,1
"102","M6 x 25 CLINCH STUD ZINC SILVER","CSTUDM625Z",100,100,0,100,0.25,1,0.25,173,0,173,43.25,"2023-09-04 11:14:21","Kanban Stock",2,1
"110","M8 x 25 CLINCH STUD ZINC SILVER","CSTUDM825Z",100,100,0,100,3,100,0.03,383,0,383,11.49,"2023-09-04 11:17:58","Kanban Stock",2,1
"55","10mm Copper Lug 10mm Stud Bell","CTL10-10",100,100,0,100,0.31,1,0.31,200,0,200,62,"2023-09-04 10:45:22","Kanban Stock",2,1
"56","10mm Copper Lug 12mm Stud Bell","CTL10-12",100,100,0,100,0.28,1,0.28,100,0,100,28,"2023-09-04 10:45:39","Kanban Stock",2,1
"53","10mm X 6 Copper Lug","CTL10-6",100,100,0,100,0.31,1,0.31,462,0,462,143.22,"2023-09-04 10:44:23","Kanban Stock",2,1
"54","10 X 8 Copper Lug","CTL10-8",100,100,0,100,0.27,1,0.27,100,0,100,27,"2023-10-04 09:51:54","Kanban Stock",2,0
"79.3","120MM COPPER LUG 10MM STUD BELL","CTL120-10",30,90,30,60,2.19,1,2.19,30,60,90,197.1,"2023-09-20 09:33:25","Kanban Stock",2,0
"79.1","120MM COPPER LUG 8MM STUD BELL","CTL120-8",30,90,30,60,2.19,1,2.19,20,240,260,569.4,"2023-09-04 11:01:22","Kanban Stock",2,1
"82","150mm Cpr Lug 10mm Stud Bell","CTL150-10",20,80,20,60,4.69,1,4.69,7,120,127,595.63,"2023-09-04 11:03:28","Kanban Stock",2,0
"81","150mm Copper Lug 8mm Stud Bell","CTL150-8",20,80,20,60,3.02,1,3.02,23,269,292,881.84,"2023-09-04 11:03:05","Kanban Stock",2,0
"59","16mm Copper Lug 10mm Stud Bell","CTL16-10",100,300,100,200,0.46,1,0.46,135,610,745,342.7,"2023-09-04 10:46:59","Kanban Stock",2,0
"57","16mm Copper Lug 6mm Stud Bell","CTL16-6",100,100,0,100,0.32,1,0.32,251,250,501,160.32,"2023-09-04 10:45:55","Kanban Stock",2,0
"58","16mm Copper Lug 8mm Stud Bell","CTL16-8",200,600,200,400,0.36,1,0.36,200,0,200,72,"2023-09-20 09:22:52","Kanban Stock",2,0
"83.1","185mm Copper Lug 10mm Stud Bell","CTL185-10",20,80,40,40,3.36,1,3.36,20,60,80,268.8,"2023-09-06 12:44:48","Kanban Stock",2,0
"85","240mm COPPER LUG 10mm STUD BELL","CTL240-10",10,50,30,20,7.72,1,7.72,10,30,40,308.8,"2023-10-06 09:45:34","Kanban Stock",2,0
"62","25mm Copper Lug 10mm Stud Bell","CTL25-10",100,300,100,200,0.5,1,0.5,115,400,515,257.5,"2023-09-04 10:48:53","Kanban Stock",2,0
"60","25mm Copper Lug 6mm Stud Bell","CTL25-6",100,100,0,100,0.48,1,0.48,172,490,662,317.76,"2023-09-04 10:47:46","Kanban Stock",2,0
"61","25mm Copper Lug 8mm Stud Bell","CTL25-8",200,600,200,400,0.44,1,0.44,200,0,200,88,"2023-10-04 10:02:18","Kanban Stock",2,0
"65","35 X 10mm LUG","CTL35-10",100,300,100,200,0.6,1,0.6,129,120,249,149.4,"2023-09-04 10:50:24","Kanban Stock",2,0
"63","35mm Copper Lug 6mm Stud Bell","CTL35-6",50,50,0,50,0.82,1,0.82,91,360,451,369.82,"2023-09-04 10:49:14","Kanban Stock",2,0
"64","35mm Copper Lug 8mm Stud Bell","CTL35-8",200,600,200,400,0.77,1,0.77,92,280,372,286.44,"2023-09-04 10:49:55","Kanban Stock",2,0
"69","50mm Copper Lug 10mm Stud Bell","CTL50-10",100,300,100,200,0.82,1,0.82,88,200,288,236.16,"2023-09-04 10:56:29","Kanban Stock",2,0
"66","50mm Copper Lug 6mm Stud Bell","CTL50-6",100,100,0,100,1.05,1,1.05,119,100,219,229.95,"2023-09-04 10:50:54","Kanban Stock",2,0
"67","50 X 8mm LUG","CTL50-8",400,1200,400,800,1.04,1,1.04,400,800,1200,1248,"2023-09-04 10:51:33","Kanban Stock",2,0
"52","6mm x 8 Copper Lug","CTL6-8",100,100,0,100,0.21,1,0.21,521,0,521,109.41,"2023-09-04 10:44:50","Kanban Stock",2,1
"74","70mm Copper Lug 10mm Stud Bell","CTL70-10",50,150,50,100,1.12,1,1.12,36,120,156,174.72,"2023-09-04 10:58:15","Kanban Stock",2,0
"70","70mm Copper Lug 6mm Stud Bell","CTL70-6",50,50,0,50,0.84,1,0.84,82,160,242,203.28,"2023-09-04 10:56:46","Kanban Stock",2,0
"72","70mm Copper Lug 8mm Stud Bell","CTL70-8",200,600,200,400,1.33,1,1.33,200,280,480,638.4,"2023-09-08 08:33:46","Kanban Stock",2,0
"78","95MM COPPER LUG 10MM STUD BELL","CTL95-10",60,180,60,120,1.93,1,1.93,32,280,312,602.16,"2023-09-04 11:00:26","Kanban Stock",2,0
"76","95MM COPPER LUG 8MM STUD BELL","CTL95-8",60,240,120,120,1.42,1,1.42,60,120,180,255.6,"2023-09-20 09:22:35","Kanban Stock",2,0
"80","Narrow Palm Lug 120-10mm","CTLNP120-10",50,50,0,50,4.35,1,4.35,20,150,170,739.5,"2023-09-04 11:02:38","Kanban Stock",2,0
"79.2","NARROW PALM LUG 120-8mm","CTLNP120-8",30,90,30,60,3.05,1,3.05,30,210,240,732,"2023-09-20 09:33:13","Kanban Stock",2,0
"83","Narrow Palm Lug 150-10mm","CTLNP150-10",20,60,20,40,5.7,1,5.7,30,100,130,741,"2023-09-04 11:04:27","Kanban Stock",2,0
"82.1","NARROW PALM LUG 150-8mm","CTLNP150-8",20,60,20,40,3.95,1,3.95,41,90,131,517.45,"2023-09-04 11:03:54","Kanban Stock",2,1
"84","Narrow Palm Lug 185-10mm","CTLNP185-10",20,80,40,40,4.45,1,4.45,8,90,98,436.1,"2023-09-04 11:05:56","Kanban Stock",2,0
"86","Narrow Palm Lug 240-10mm","CTLNP240-10",10,50,30,20,6.97,1,6.97,10,20,30,209.1,"2023-10-06 09:45:19","Kanban Stock",2,0
"75","Narrow Palm Lug 70-10mm","CTLNP70-10",100,100,0,100,2.24,1,2.24,60,0,60,134.4,"2023-09-04 10:59:20","Kanban Stock",2,1
"71","Narrow Palm Lug 70-6mm","CTLNP70-6",50,50,0,50,1.71,1,1.71,32,80,112,191.52,"2023-09-04 10:57:08","Kanban Stock",2,1
"79","95 x 10mm NARROW PALM LUG","CTLNP95-10",50,50,0,50,2.46,1,2.46,58,0,58,142.68,"2023-09-04 11:00:57","Kanban Stock",2,1
"77","NARROW PALM LUG 95-8mm","CTLNP95-8",60,180,60,120,2.56,1,2.56,60,40,100,256,"2023-09-04 11:00:01","Kanban Stock",2,0
"105","105-empty","Empty105",0,0,0,0,0,0,\N,1,0,1,\N,"2023-09-04 11:15:42","Kanban Stock",2,1
"128","128-empty","empty128",0,0,0,0,0,0,\N,0,10,10,\N,"2023-09-12 16:17:37","Kanban Stock",0,1
"184","EMPTY184","EMPTY184",0,0,0,0,0,0,\N,500,0,500,\N,"2023-06-28 14:33:06","Kanban Stock",2,1
"185","EMPTY185","EMPTY185",0,0,0,0,0,0,\N,500,0,500,\N,"2023-06-28 14:33:06","Kanban Stock",2,1
"186","EMPTY186","EMPTY186",0,0,0,0,0,0,\N,500,0,500,\N,"2023-06-28 14:33:06","Kanban Stock",2,1
"187","EMPTY187","EMPTY187",0,0,0,0,0,0,\N,500,0,500,\N,"2023-06-28 14:33:06","Kanban Stock",2,1
"188","EMPTY188","EMPTY188",0,0,0,0,0,0,\N,500,0,500,\N,"2023-06-28 14:33:06","Kanban Stock",2,1
"189","EMPTY189","EMPTY189",0,0,0,0,0,0,\N,500,0,500,\N,"2023-06-28 14:33:06","Kanban Stock",2,1
"190","EMPTY190","EMPTY190",0,0,0,0,0,0,\N,500,0,500,\N,"2023-06-28 14:33:06","Kanban Stock",2,1
"30","BLADE RED 10mm COPPER SLEEVE","FB1-10CS",200,600,200,400,6.43,100,0.0643,1305,3500,4805,308.962,"2023-09-04 10:30:48","Kanban Stock",2,0
"38","BLADE BLUE 13MM COPPER SLEEVE","FB2-13CS",100,300,100,200,8.08,100,0.0808,1059,500,1559,125.967,"2023-09-04 10:35:27","Kanban Stock",2,0
"45","Blade Yellow 10mm Copper Sleeve","FB5-10CS",100,100,0,100,9.3,100,0.093,51,0,51,4.743,"2023-09-04 10:38:29","Kanban Stock",2,1
"44","Blade Yellow 18mm Copper Sleeve","FB5-18CS",100,100,0,100,12.24,100,0.1224,100,0,100,12.24,"2023-09-04 10:38:03","Kanban Stock",2,1
"170","M10 X 25 GRUB SCREW","GSM1025P",100,100,0,100,0.3091,100,0.003091,396,0,396,1.22404,"2023-09-04 11:51:35","Kanban Stock",2,1
"168","M6 X 25 GRUB SCREW","GSM625P",200,200,0,200,0.1545,100,0.001545,312,0,312,0.48204,"2023-09-04 11:50:55","Kanban Stock",2,0
"169","M8 X 25 GRUB SCREW","GSM825P",200,200,0,200,0.2091,100,0.002091,391,400,791,1.65398,"2023-09-04 11:51:17","Kanban Stock",2,0
"182","M5x65 PAN SCREW","LLLLLL",50,50,0,50,0,0,\N,88,0,88,\N,"2023-09-04 11:55:28","Kanban Stock",2,1
"87","M4 x 10 MACHINE SCREW CHEESE SLOT ZP","MTM410CHSZ",500,1500,500,1000,0.0364,1,0.0364,500,500,1000,36.4,"2023-09-27 09:11:01","Kanban Stock",2,0
"139","M5 X 20 PAN PHIL METAL THREAD","MTM520CXZ",400,400,0,400,0.0473,1,0.0473,680,0,680,32.164,"2023-09-04 11:38:00","Kanban Stock",2,0
"141","M5 X 30 PAN PHIL METAL THREAD","MTM530CXZ",100,300,100,200,0.0434,1,0.0434,567,0,567,24.6078,"2023-09-04 11:38:50","Kanban Stock",2,0
"151","M6 X 20 MACHINE SCREWS PAN SLO","MTM620PSBR",200,200,0,200,0.1046,1,0.1046,400,1000,1400,146.44,"2023-09-04 11:43:03","Kanban Stock",2,0
"152","M6 X 30 MACHINE SCREWS PAN ","MTM630PSBR",200,200,0,200,0.9,1,0.9,202,800,1002,901.8,"2023-09-04 11:43:17","Kanban Stock",2,0
"101","M6 X 40 PAN PHIL METAL THREAD","MTM640PXZ",100,100,0,100,13.18,100,0.1318,214,1000,1214,160.005,"2023-09-04 11:14:04","Kanban Stock",2,0
"144","5MM BRASS NUT","NM5BR",250,250,0,250,0.1112,1,0.1112,837,0,837,93.0744,"2023-09-04 11:39:59","Kanban Stock",2,1
"97","M5 HEX NUT ZP","NM5Z",500,500,0,500,0.018,1,0.018,1630,3000,4630,83.34,"2023-09-04 11:12:08","Kanban Stock",2,0
"154","6MM BRASS NUT","NM6BR",150,150,0,150,0.1762,1,0.1762,798,400,1198,211.088,"2023-09-04 11:44:06","Kanban Stock",2,0
"107","6mm nut","NM6Z",500,1500,500,1000,0.0227,1,0.0227,500,2000,2500,56.75,"2023-09-04 11:16:33","Kanban Stock",2,0
"180","8MM NUT SS","NM8S",250,250,0,250,0.0664,1,0.0664,240,0,240,15.936,"2023-09-04 11:54:52","Kanban Stock",2,1
"131","RIVET BLIND ALUM DOME (ASP-5-4)","RAS54",500,1500,500,1000,0.0211,1,0.0211,500,1000,1500,31.65,"2023-09-27 08:59:32","Kanban Stock",2,0
"133","6 - 12 Rivet","RAS612",250,250,0,250,0.0573,1,0.0573,203,250,453,25.9569,"2023-09-04 11:28:57","Kanban Stock",2,0
"132","RIVET ALUMINIUM STEEL STEM 6-8","RAS68",500,1500,500,1000,0.0359,1,0.0359,250,3000,3250,116.675,"2023-09-06 12:46:54","Kanban Stock",2,0
"31","Ring Red 8mm","RL1-8",300,900,300,600,5.68,100,0.0568,781,3500,4281,243.161,"2023-09-04 10:31:15","Kanban Stock",2,0
"36","Round Lug Ring Blue 6mm","RL2-6",300,900,300,600,5.9,100,0.059,604,4000,4604,271.636,"2023-09-04 10:34:27","Kanban Stock",2,0
"37","RING TERMANAL STD 1.04-2.63mm","RL2-8",300,900,300,600,5.1,100,0.051,295,300,595,30.345,"2023-09-04 10:34:53","Kanban Stock",2,0
"42","Ring Yellow 10mm Copper Sleeve","RL5-10CS",100,100,0,100,19.76,100,0.1976,100,0,100,19.76,"2023-09-06 11:31:27","Kanban Stock",2,1
"43","Ring Yellow 12mm Copper Sleeve","RL5-12CS",100,100,0,100,19.4,100,0.194,399,0,399,77.406,"2023-09-04 10:37:21","Kanban Stock",2,1
"39","Ring Yellow 5mm Copper Sleeve","RL5-5CS",100,300,100,200,15.11,100,0.1511,515,200,715,108.036,"2023-09-04 10:35:51","Kanban Stock",2,0
"40","Ring Yellow 6mm Copper Sleeve","RL5-6CS",400,1200,400,800,18.01,100,0.1801,400,700,1100,198.11,"2023-09-04 10:36:13","Kanban Stock",2,0
"41","Ring Yellow 8mm Copper Sleeve","RL5-8CS",400,1200,400,800,21.44,100,0.2144,400,3400,3800,814.72,"2023-10-06 09:50:33","Kanban Stock",2,0
"48.2","M8 X 25 MM SOCKET HEAD CAP SCREW CL 12.9 ZP","SHCSM825Z",100,300,100,200,0.1476,1,0.1476,100,700,800,118.08,"2023-09-04 10:40:21","Kanban Stock",2,0
"26","Spade Red 3mm","SL1-3",100,300,100,200,3.84,100,0.0384,1106,1400,2506,96.2304,"2023-09-04 10:29:14","Kanban Stock",2,0
"27","Spade Red 3.5mm","SL1-3.5",200,600,200,400,3.86,100,0.0386,1192,1500,2692,103.911,"2023-09-04 10:29:37","Kanban Stock",2,0
"28","Spade Red 5mm","SL1-5",200,600,200,400,4.73,100,0.0473,804,700,1504,71.1392,"2023-09-04 10:30:12","Kanban Stock",2,0
"29","SPADE RED 6MM","SL1-6",200,600,200,400,5.61,100,0.0561,1071,2000,3071,172.283,"2023-09-04 10:30:32","Kanban Stock",2,0
"32","Spade Blue 3mm","SL2-3",200,200,0,200,4.69,100,0.0469,791,0,791,37.0979,"2023-09-04 10:31:32","Kanban Stock",2,1
"33","Spade Blue 3mm","SL2-3.5",200,600,200,400,4.57,100,0.0457,1027,2100,3127,142.904,"2023-09-04 10:32:05","Kanban Stock",2,0
"34","Spade Blue 5mm","SL2-5",200,600,200,400,3.85,100,0.0385,240,1000,1240,47.74,"2023-09-04 10:33:15","Kanban Stock",2,0
"35","Spade Blue 6mm Copper Sleeve","SL2-6CS",100,100,0,100,7.66,100,0.0766,82,0,82,6.2812,"2023-09-04 10:33:37","Kanban Stock",2,1
"48.1","Spade Yellow 5mm","SL5-5",100,100,0,100,9.91,100,0.0991,500,0,500,49.55,"2023-09-04 10:39:58","Kanban Stock",2,1
"163","M10 X 120MM SCREW","SSM10120ZP",50,150,50,100,1,1,1,66,50,116,116,"2023-09-04 11:49:05","Kanban Stock",2,0
"117","M10 X 16 Hex Crew","SSM1016Z8",100,300,100,200,0.1358,1,0.1358,240,300,540,73.332,"2023-09-04 11:21:36","Kanban Stock",2,0
"118","M10 X 20 HEX SET SCREW CL 8.8","SSM1020Z8",100,300,100,200,0.1241,1,0.1241,197,300,497,61.6777,"2023-09-04 11:21:56","Kanban Stock",2,0
"119","M10 X 25 HEX SET SCREW CL 8.8 ZINC SILVER","SSM1025Z8",100,300,100,200,0.1545,1,0.1545,120,350,470,72.615,"2023-09-04 11:22:26","Kanban Stock",2,0
"161","M10 X 40MM SCREW","SSM1040Z8",100,300,100,200,0.2,1,0.2,100,200,300,60,"2023-09-04 11:47:55","Kanban Stock",2,0
"162","M10 X 50MM SCREW","SSM1050ZP",100,300,100,200,0.2,1,0.2,75,220,295,59,"2023-09-04 11:48:33","Kanban Stock",2,0
"125","SCREW M12 X 45 HEX SET 8.8 F/T","SSM1245Z8",50,150,50,100,0.3,1,0.3,50,400,450,135,"2023-09-04 11:25:33","Kanban Stock",2,0
"138","M5 x 20 Screw","SSM520Z8",200,400,200,200,0.0605,1,0.0605,624,800,1424,86.152,"2023-09-04 11:32:02","Kanban Stock",2,1
"148","6 X 25MM HEX HEAD SCREW","SSM625Z8",300,900,300,600,0.0424,1,0.0424,300,0,300,12.72,"2023-10-04 09:49:43","Kanban Stock",2,0
"100","6 X 30MM HEX HEAD SCREW","SSM630Z8",200,200,0,200,0.9,1,0.9,63,0,63,56.7,"2023-09-04 11:13:10","Kanban Stock",2,1
"134","M8 x 25 Stailess Steel Bolts","SSM825S",100,100,0,100,0.1818,1,0.1818,133,400,533,96.8994,"2023-09-04 11:29:26","Kanban Stock",2,0
"112","M8 X 25 HEX SET SCREW CL 8.8 Z","SSM825Z8",400,1200,400,800,0.0766,1,0.0766,0,0,0,0,"2023-10-04 10:01:18","Kanban Stock",2,0
"113","M8X30 SET SCREW","SSM830Z8",200,600,200,400,0.07,1,0.07,200,0,200,14,"2023-10-04 10:01:33","Kanban Stock",2,0
"174","M8 X 45MM SCREW","SSM845S",250,250,0,250,0.1318,1,0.1318,137,700,837,110.317,"2023-09-04 11:52:48","Kanban Stock",2,0
"157","M8 X 75 HEX SET SCREW CL 8.8 ZINC SILVER","SSM875Z8",50,150,50,100,0.2273,1,0.2273,56,200,256,58.1888,"2023-09-04 11:45:03","Kanban Stock",2,0
"129","10G X 1 IN PAN XR SELF TAPPING","ST101PXZ",1000,3000,1000,2000,0.03,1,0.03,1000,2000,3000,90,"2023-09-27 09:18:33","Kanban Stock",2,0
"49","SELF TAPPER 10G X ¾(20MM) PAN XR PHILLIPS ZINC","ST1034PXZ",1000,1000,1000,0,0.03,1,0.03,900,0,900,27,"2023-10-04 09:48:29","Kanban Stock",2,1
"173","8G X 1 IN PAN XR SELF TAPPING SCREW ZP","ST81PXZ",1000,1000,0,1000,27.3,1000,0.0273,773,2000,2773,75.7029,"2023-09-04 11:52:26","Kanban Stock",2,0
"171","SCREW 8-18 X 12 METAL SDS BUTTON WAFER HEAD","TSB812ZY",1000,3000,1000,2000,0.022,1,0.022,1000,1000,2000,44,"2023-09-27 09:33:13","Kanban Stock",2,0
"172","12mm SADDLE MOUNTING SCREW","TSP8127",1000,2000,1000,1000,1,100,0.01,1028,0,1028,10.28,"2023-09-04 11:52:11","Kanban Stock",2,1
"181","Self Tapping Screw 5mm x 12","TTM512PZZ",500,500,0,500,0.12,1,0.12,2001,0,2001,240.12,"2023-09-04 11:55:14","Kanban Stock",2,1
"23","Ferrule Uninsulated 10mm long","UBL100L",100,100,0,100,0.51,10,0.051,1033,0,1033,52.683,"2023-09-04 10:27:53","Kanban Stock",2,1
"24","Ferrule Uninsulated 16mm long","UBL160L",100,100,0,100,0.7,10,0.07,435,0,435,30.45,"2023-09-04 10:28:17","Kanban Stock",2,1
"25","Ferrule Uninsulated 25mm long","UBL250L",100,100,0,100,1.01,10,0.101,198,0,198,19.998,"2023-09-04 10:28:40","Kanban Stock",2,1
"106","WASHER FLAT ROUND ZINC 6mm (1/4)","WASHM6ZP",400,800,400,400,0.0426,1,0.0426,1152,7500,8652,368.575,"2023-09-04 11:16:07","Kanban Stock",2,0
"46","WASHER LOAD M8X 18 X 2 HDS Z/P","WBM8182Z",1000,3000,1000,2000,0.2,1,0.2,1000,0,1000,200,"2023-10-06 09:48:29","Kanban Stock",2,0
"98","5MM EXTERNAL TOOTH WASHER ZP","WETM5Z",500,500,0,500,0.011,1,0.011,2544,0,2544,27.984,"2023-09-04 11:12:27","Kanban Stock",2,1
"149","6MM EXTERNAL TOOTH WASHER ZP ","WETM6Z",1000,1000,0,1000,0.02,1,0.02,1185,0,1185,23.7,"2023-09-04 11:41:59","Kanban Stock",2,1
"96","3/16X1/2X20G FLAT WASHER ZP","WF3161220Z",1000,3000,1000,2000,0.0118,1,0.0118,400,0,400,4.72,"2023-10-06 09:49:42","Kanban Stock",2,0
"160","5/16 X 1 1/4 X 16G FLAT WASHER","WF51611416Z",600,1800,600,1200,0.0667,1,0.0667,600,1000,1600,106.72,"2023-09-06 12:41:18","Kanban Stock",2,0
"143","5mm Brass Flat Washer","WFM5BR",500,500,0,500,0.0441,1,0.0441,2171,0,2171,95.7411,"2023-09-04 11:39:41","Kanban Stock",2,1
"153","6MM FL BR WASHER","WFM6BR",300,300,0,300,0.0818,1,0.0818,1710,0,1710,139.878,"2023-09-04 11:43:34","Kanban Stock",2,1
"178","6MM FL WASHER SS","WFM6S",250,250,0,250,0.0136,1,0.0136,730,0,730,9.928,"2023-09-04 11:54:20","Kanban Stock",2,1
"104","M6 X 12.5 X 1.2 FLAT WASHER ZP","WFM6Z",1000,2000,1000,1000,0,0,\N,2082,3400,5482,\N,"2023-09-04 11:15:17","Kanban Stock",2,0
"166","Lockwasher 10mm internal","WITM10Z",1000,1000,0,1000,0.0455,1,0.0455,986,0,986,44.863,"2023-09-04 11:50:09","Kanban Stock",2,1
"99","5MM INTERNAL TOOTH WASHER ZP","WITM5Z",500,500,0,500,0.0152,1,0.0152,2003,0,2003,30.4456,"2023-09-04 11:12:52","Kanban Stock",2,1
"150","6MM INTERNAL TOOTH WASHER ZP ","WITM6Z",1000,1000,0,1000,0.017,1,0.017,1663,1000,2663,45.271,"2023-09-04 11:42:42","Kanban Stock",2,1
"115","8MM INTERNAL TOOTH WASHER ZP","WITM8Z",1000,1000,0,1000,0.0306,1,0.0306,2133,4200,6333,193.79,"2023-09-04 11:20:32","Kanban Stock",2,0
"47","WASHER LOAD M10 X 23 X 2.5 HDS Z/P","WLM10Z",500,1500,500,1000,0.3,1,0.3,500,500,1000,300,"2023-09-06 12:39:01","Kanban Stock",2,0
"48","WASHER LOAD M12","WLM12Z",150,450,150,300,0.606,1,0.606,150,300,450,272.7,"2023-09-27 09:00:52","Kanban Stock",2,0
"177","10MM SP WASHER SS","WSM10S",250,250,0,250,0.0415,1,0.0415,648,0,648,26.892,"2023-09-04 11:54:07","Kanban Stock",2,1
"175","6MM SP WASHER SS","WSM6S",250,250,0,250,0.0148,1,0.0148,6774,0,6774,100.255,"2023-09-04 11:53:14","Kanban Stock",2,1
"176","8MM SP WASHER SS","WSM8S",250,250,0,250,0.0258,1,0.0258,3324,0,3324,85.7592,"2023-09-04 11:53:54","Kanban Stock",2,1
"142","5mm Brass Spring Washer","xxxx",500,500,0,500,0.0441,1,0.0441,38,0,38,1.6758,"2023-09-04 11:39:23","Kanban Stock",2,1
